LLLLLLLLLLLLLLLLLLLLLLLLLLLLLLLLLLLLLLLLLLLLLLLLLLLLLLLLLLLLLLLLLLLLLLLLLLLLLLLLLLLLLLLLLLLLLLLLLLLLLLLLLLLLLLLLLLLLLLLLLLLLLLLLLLLLLLLLLLLLLL
L   mWgW    aLmWgW      WaLmWW    aLa    mWgW  L        mLmWWg   WaLmg      L mWgW    aLmWgW    a mWW    aLa    mWgW  L        mLmWWg   aLmg L
LA WLWWWW    LWWWW       WL WWW   gL     WWW  aLaWWW     LWWWW    WL        L      WWWW      WWWW    L     WWW  aLaWWW     LWWWW    L        L
LWWmLmWWWLWWmLmWWWLm      LmWWWLWWmLmWW L      LmWWWLW   LmWWW m   L  WWLWWWLWWmLmWWMLm   LmWWWLWWmLmWW L      LmWWWLW   LmWWWLm   LmWWWL    L
LW WLWWWaLW WLWWWaL      WLWWWaLW  LWWg L      LWWWgLWm  LWWWaL    LWWWaLWW LWWWa W WLWWWa    WLWWWa W   WWg        LWWWgLWm  LWWWaL    LWWWaL
LWWWLWWWWLWWWLWWWWL     WgLWW WLWW LWW  L      LmWWWLW   LWWWWLWW gLWWWWLWWWLWWWW WWWLWWWW   WgLWW W WW  WW         LmWWWLW   LWWWWLWW gLWWWWL
LWWgLgWWWLgWWLgWWWLa     WLgW  LgWWLmW  Lm     LWWW LgW  LgWWWLaW  LgWWWLWWgLgWWW gWWLgWWW a  WLgW   gWWLmW  Lm     LWWW LWg  LgWWWLa   LgWWWL
LWWW W   L W    WWL        W   L    WW  L           L W  WWW  L     W   LWWWLW     W    WW      WW  L    WW  L           LWWW WWW  L         L
LWa     mLWaW    mL           mLWaW     L  g       aLWaW    m Lm       mLWa     mLWaW    m       m  LWaW     L  g       aLWaW    m L        mL
LLLLLLLLLLLLLLLLLLLLLLLLLLLLLLLLLLLLLLLLLLLLLLLLLLLLLLLLLLLLLLLLLLLLLLLLLLLLLLLLLLLLLLLLLLLLLLLLLLLLLLLLLLLLLLLLLLLLLLLLLLLLLLLLLLLLLLLLLLLLLL
L   mWgW    aLmWgW      WaLmWW    aLa    mWgW  L        mLmWWg   WaLmg      L mWgW    aLmWgW    a mWW    aLa    mWgW  L        mLmWWg   aLmg L
LA WLWWWW    LWWWW       WL WWW   gL     WWW  aLaWWW     LWWWW    WL        L      WWWW      WWWW    L     WWW  aLaWWW     LWWWW    L        L
LWWmLmWWWLWWmLmWWWLm      LmWWWLWWmLmWW L      LmWWWLW   LmWWW m   L  WWLWWWLWWmLmWWMLm   LmWWWLWWmLmWW L      LmWWWLW   LmWWWLm   LmWWWL    L
LW WLWWWaLW WLWWWaL      WLWWWaLW  LWWg L      LWWWgLWm  LWWWaL    LWWWaLWW LWWWa W WLWWWa    WLWWWa W   WWg        LWWWgLWm  LWWWaL    LWWWaL
LWWWLWWWWLWWWLWWWWL     WgLWW WLWW LWW  L      LmWWWLW   LWWWWLWW gLWWWWLWWWLWWWW WWWLWWWW   WgLWW W WW  WW         LmWWWLW   LWWWWLWW gLWWWWL
LWWgLgWWWLgWWLgWWWLa     WLgW  LgWWLmW  Lm     LWWW LgW  LgWWWLaW  LgWWWLWWgLgWWW gWWLgWWW a  WLgW   gWWLmW  Lm     LWWW LWg  LgWWWLa   LgWWWL
LWWW W   L W    WWL        W   L    WW  L           L W  WWW  L     W   LWWWLW     W    WW      WW  L    WW  L           LWWW WWW  L         L
LWa     mLWaW    mL           mLWaW     L  g       aLWaW    m Lm       mLWa     mLWaW    m       m  LWaW     L  g       aLWaW    m L        mL
LLLLLLLLLLLLLLLLLLLLLLLLLLLLLLLLLLLLLLLLLLLLLLLLLLLLLLLLLLLLLLLLLLLLLLLLLLLLLLLLLLLLLLLLLLLLLLLLLLLLLLLLLLLLLLLLLLLLLLLLLLLLLLLLLLLLLLLLLLLLLL
L   mWgW    aLmWgW      WaLmWW    aLa    mWgW  L        mLmWWg   WaLmg      L mWgW    aLmWgW    a mWW    aLa    mWgW  L        mLmWWg   aLmg L
LA WLWWWW    LWWWW       WL WWW   gL     WWW  aLaWWW     LWWWW    WL        L      WWWW      WWWW    L     WWW  aLaWWW     LWWWW    L        L
LWWmLmWWWLWWmLmWWWLm      LmWWWLWWmLmWW L      LmWWWLW   LmWWW m   L  WWLWWWLWWmLmWWMLm   LmWWWLWWmLmWW L      LmWWWLW   LmWWWLm   LmWWWL    L
LW WLWWWaLW WLWWWaL      WLWWWaLW  LWWg L      LWWWgLWm  LWWWaL    LWWWaLWW LWWWa W WLWWWa    WLWWWa W   WWg        LWWWgLWm  LWWWaL    LWWWaL
LWWWLWWWWLWWWLWWWWL     WgLWW WLWW LWW  L      LmWWWLW   LWWWWLWW gLWWWWLWWWLWWWW WWWLWWWW   WgLWW W WW  WW         LmWWWLW   LWWWWLWW gLWWWWL
LWWgLgWWWLgWWLgWWWLa     WLgW  LgWWLmW  Lm     LWWW LgW  LgWWWLaW  LgWWWLWWgLgWWW gWWLgWWW a  WLgW   gWWLmW  Lm     LWWW LWg  LgWWWLa   LgWWWL
LWWW W   L W    WWL        W   L    WW  L           L W  WWW  L     W   LWWWLW     W    WW      WW  L    WW  L           LWWW WWW  L         L
LWa     mLWaW    mL           mLWaW     L  g       aLWaW    m Lm       mLWa     mLWaW    m       m  LWaW     L  g       aLWaW    m L        mL
LLLLLLLLLLLLLLLLLLLLLLLLLLLLLLLLLLLLLLLLLLLLLLLLLLLLLLLLLLLLLLLLLLLLLLLLLLLLLLLLLLLLLLLLLLLLLLLLLLLLLLLLLLLLLLLLLLLLLLLLLLLLLLLLLLLLLLLLLLLLLL
L   mWgW    aLmWgW      WaLmWW    aLa    mWgW  L        mLmWWg   WaLmg      L mWgW    aLmWgW    a mWW    aLa    mWgW  L        mLmWWg   aLmg L
LA WLWWWW    LWWWW       WL WWW   gL     WWW  aLaWWW     LWWWW    WL        L      WWWW      WWWW    L     WWW  aLaWWW     LWWWW    L        L
LWWmLmWWWLWWmLmWWWLm      LmWWWLWWmLmWW L      LmWWWLW   LmWWW m   L  WWLWWWLWWmLmWWMLm   LmWWWLWWmLmWW L      LmWWWLW   LmWWWLm   LmWWWL    L
LW WLWWWaLW WLWWWaL      WLWWWaLW  LWWg L      LWWWgLWm  LWWWaL    LWWWaLWW LWWWa W WLWWWa    WLWWWa W   WWg        LWWWgLWm  LWWWaL    LWWWaL
LWWWLWWWWLWWWLWWWWL     WgLWW WLWW LWW  L      LmWWWLW   LWWWWLWW gLWWWWLWWWLWWWW WWWLWWWW   WgLWW W WW  WW         LmWWWLW   LWWWWLWW gLWWWWL
LWWgLgWWWLgWWLgWWWLa     WLgW  LgWWLmW  Lm     LWWW LgW  LgWWWLaW  LgWWWLWWgLgWWW gWWLgWWW a  WLgW   gWWLmW  Lm     LWWW LWg  LgWWWLa   LgWWWL
LWWW W   L W    WWL        W   L    WW  L           L W  WWW  L     W   LWWWLW     W    WW      WW  L    WW  L           LWWW WWW  L         L
LWa     mLWaW    mL           mLWaW     L  g       aLWaW    m Lm       mLWa     mLWaW    m       m  LWaW     L  g       aLWaW    m L        mL
LLLLLLLLLLLLLLLLLLLLLLLLLLLLLLLLLLLLLLLLLLLLLLLLLLLLLLLLLLLLLLLLLLLLLLLLLLLLLLLLLLLLLLLLLLLLLLLLLLLLLLLLLLLLLLLLLLLLLLLLLLLLLLLLLLLLLLLLLLLLLL
L   mWgW    aLmWgW      WaLmWW    aLa    mWgW  L        mLmWWg   WaLmg      L mWgW    aLmWgW    a mWW    aLa    mWgW  L        mLmWWg   aLmg L
LA WLWWWW    LWWWW       WL WWW   gL     WWW  aLaWWW     LWWWW    WL        L      WWWW      WWWW    L     WWW  aLaWWW     LWWWW    L        L
LWWmLmWWWLWWmLmWWWLm      LmWWWLWWmLmWW L      LmWWWLW   LmWWW m   L  WWLWWWLWWmLmWWMLm   LmWWWLWWmLmWW L      LmWWWLW   LmWWWLm   LmWWWL    L
LW WLWWWaLW WLWWWaL      WLWWWaLW  LWWg L      LWWWgLWm  LWWWaL    LWWWaLWW LWWWa W WLWWWa    WLWWWa W   WWg        LWWWgLWm  LWWWaL    LWWWaL
LWWWLWWWWLWWWLWWWWL     WgLWW WLWW LWW  L      LmWWWLW   LWWWWLWW gLWWWWLWWWLWWWW WWWLWWWW   WgLWW W WW  WW         LmWWWLW   LWWWWLWW gLWWWWL
LWWgLgWWWLgWWLgWWWLa     WLgW  LgWWLmW  Lm     LWWW LgW  LgWWWLaW  LgWWWLWWgLgWWW gWWLgWWW a  WLgW   gWWLmW  Lm     LWWW LWg  LgWWWLa   LgWWWL
LWWW W   L W    WWL        W   L    WW  L           L W  WWW  L     W   LWWWLW     W    WW      WW  L    WW  L           LWWW WWW  L         L
LWa     mLWaW    mL           mLWaW     L  g       aLWaW    m Lm       mLWa     mLWaW    m       m  LWaW     L  g       aLWaW    m L        mL
LLLLLLLLLLLLLLLLLLLLLLLLLLLLLLLLLLLLLLLLLLLLLLLLLLLLLLLLLLLLLLLLLLLLLLLLLLLLLLLLLLLLLLLLLLLLLLLLLLLLLLLLLLLLLLLLLLLLLLLLLLLLLLLLLLLLLLLLLLLLLL