WWWWWWWWWWWWWWWWWWWWW
W                   W          
W                   W
W                   W
W                   W
W                   W
W                   W
W                   W
W                   W
W                   W
W                   W
W                   W
WWWWWWWWWWWWWWWWWWWWW