ggggWWWWWWWWWWWWgggg
gL gW           g Lg
g AgW     g     gA g
gggmW          WmggW
WWWWW          WW  W
W         a        W
W                  W
WWWWWW         WWWWW
WggWmW         WmgggW
WLAgWW         WgALW
WggWmW    A   WmWggW
WWWWWW         WWWWW
W                  W
W                  W
W                  W
WWWWW          WWWWW
gggmW     a    Wmggg
W AgW          WgA g
WL gW          Wg Lg
ggggWWWWWWWWWWWWgggg