ggggWWWWWWWWWWWWgggg WWWWWWWWWWWWWWWWWWWWW WWWWWWWWWWWWWWWWWWWWW WWWWWWWWWWWWWWWWWWWWW WWWWWWWWWWWWWWWWWWWWW
gL g            g LggWL g            g LW WL g            g LW WL g            g LW WL g            g LW
g Ag            gA W W Ag            gA W W Ag            gA W W Ag            gA W W Ag            gA W
gggmW          WmggW WggmW          WmggW WggmW          WmggW WggmW          WmggW WggmW          WmggW
W  WW           W  W W  WW           W  W W  WW           W  W W  WW           W  W W  WW           W  W
W                  W W                  W W                  W W                  W W                  W
W                  W W                  W W                  W W                  W W                  W
W   W          W   W W   W          W   W W   W          W   W W   W          W   W W   W          W   W
WggWmW         WmWggW WggWmW         WmWggW WggWmW         WmWggW WggWmW         WmWggW WggWmW         WmWggW
WLAgWW        WWgALW WLAgWW        WWgALW WLAgWW        WWgALW WLAgWW        WWgALW WLAgWW        WWgALW
WggWmW        WmWggW WggWmW        WmWggW WggWmW        WmWggW WggWmW        WmWggW WggWmW        WmWggW
W   W          W   W W   W          W   W W   W          W   W W   W          W   W W   W          W   W
W                  W W                  W W                  W W                  W W                  W
W                  W W                  W W                  W W                  W W                  W
W                  W W                  W W                  W W                  W W                  W
W WWW          WWW W W WWW          WWW W W WWW          WWW W W WWW          WWW W W WWW          WWW W
WggmW          WmggW WggmW          WmggW WggmW          WmggW WggmW          WmggW WggmW          WmggW
W AgW          WgAWW W AgW          WgAWW W AgW          WgAWW W AgW          WgAWW W AgW          WgAWW
WL g            g LW WL g            g LW WL g            g LW WL g            g LW WL g            g LW
WWWWWWWWWWWWWWWWWWWW WWWWWWWWWWWWWWWWWWWWW WWWWWWWWWWWWWWWWWWWWW WWWWWWWWWWWWWWWWWWWWW WWWWWWWWWWWWWWWWWWWWW