ggggWWWWWWWWWWWWgggg
gL g            g Lg
g Ag      g     gA g
gggmW          WmggW
W  WW          WW  W
W         a        W
W                  W
W   WW         WW  W
WggWmW        WmWggW
WLAgWW         WgALW
WggWmW    A   WmWggW
W   W          W   W
W                  W
W         g        W
W                  W
W WWW          WWW W
gggmW     a    Wmggg
W AgW          WgA g
WL g            g Lg
ggggWWWWWWWWWWWWgggg