WWWWWWWWWWWWWWWWWWWW
W                  W
W         a        W
W    A             W
W                  W
W                  W
W         W        W
W       WWgWW      W
W      WmgAgmW     W
W       WgLgW      W
W      WmgAgmW     W
W       WWgWW      W
W         W        W
W                  W
W                  W
W         a    A   W
W                  W
W                  W
W                  W
WWWWWWWWWWWWWWWWWWWW