LLLLLLLLLLLLLLL    LLLLLLLLLLLLLLL     LLLLLLLLLLLLLLL    LLLLLLLLLLLLLLL
W      A      W    W      A      W     W      A      W    W      A      W
mmmmmmmmmmmmmmm    mmmmmmmmmmmmmmm     mmmmmmmmmmmmmmm    mmmmmmmmmmmmmmm
WAW    g    WAW    WAW    g    WAW     WAW    g    WAW    WAW    g    WAW
WW           WW    WW           WW     WW           WW    WW           WW
g     aaa     g    g     aaa     g     g     aaa     g    g     aaa     g
WWW          WW    WWW          WW     WWW          WW    WWW          WW
WAW    g    WAW    WAW    g    WAW     WAW    g    WAW    WAW    g    WAW
mmmmmmmmmmmmmmm    mmmmmmmmmmmmmmm     mmmmmmmmmmmmmmm    mmmmmmmmmmmmmmm
W      A      W    W      A      W     W      A      W    W      A      W
LLLLLLLLLLLLLLL    LLLLLLLLLLLLLLL     LLLLLLLLLLLLLLL    LLLLLLLLLLLLLLL

LLLLLLLLLLLLLLL    LLLLLLLLLLLLLLL     LLLLLLLLLLLLLLL    LLLLLLLLLLLLLLL
W      A      W    W      A      W     W      A      W    W      A      W
mmmmmmmmmmmmmmm    mmmmmmmmmmmmmmm     mmmmmmmmmmmmmmm    mmmmmmmmmmmmmmm
WAW    g    WAW    WAW    g    WAW     WAW    g    WAW    WAW    g    WAW
WW           WW    WW           WW     WW           WW    WW           WW
g     aaa     g    g     aaa     g     g     aaa     g    g     aaa     g
WWW          WW    WWW          WW     WWW          WW    WWW          WW
WAW    g    WAW    WAW    g    WAW     WAW    g    WAW    WAW    g    WAW
mmmmmmmmmmmmmmm    mmmmmmmmmmmmmmm     mmmmmmmmmmmmmmm    mmmmmmmmmmmmmmm
W      A      W    W      A      W     W      A      W    W      A      W
LLLLLLLLLLLLLLL    LLLLLLLLLLLLLLL     LLLLLLLLLLLLLLL    LLLLLLLLLLLLLLL

LLLLLLLLLLLLLLL    LLLLLLLLLLLLLLL     LLLLLLLLLLLLLLL    LLLLLLLLLLLLLLL
W      A      W    W      A      W     W      A      W    W      A      W
mmmmmmmmmmmmmmm    mmmmmmmmmmmmmmm     mmmmmmmmmmmmmmm    mmmmmmmmmmmmmmm
WAW    g    WAW    WAW    g    WAW     WAW    g    WAW    WAW    g    WAW
WW           WW    WW           WW     WW           WW    WW           WW
g     aaa     g    g     aaa     g     g     aaa     g    g     aaa     g
WWW          WW    WWW          WW     WWW          WW    WWW          WW
WAW    g    WAW    WAW    g    WAW     WAW    g    WAW    WAW    g    WAW
mmmmmmmmmmmmmmm    mmmmmmmmmmmmmmm     mmmmmmmmmmmmmmm    mmmmmmmmmmmmmmm
W      A      W    W      A      W     W      A      W    W      A      W
LLLLLLLLLLLLLLL    LLLLLLLLLLLLLLL     LLLLLLLLLLLLLLL    LLLLLLLLLLLLLLL

LLLLLLLLLLLLLLL    LLLLLLLLLLLLLLL     LLLLLLLLLLLLLLL    LLLLLLLLLLLLLLL
W      A      W    W      A      W     W      A      W    W      A      W
mmmmmmmmmmmmmmm    mmmmmmmmmmmmmmm     mmmmmmmmmmmmmmm    mmmmmmmmmmmmmmm
WAW    g    WAW    WAW    g    WAW     WAW    g    WAW    WAW    g    WAW
WW           WW    WW           WW     WW           WW    WW           WW
g     aaa     g    g     aaa     g     g     aaa     g    g     aaa     g
WWW          WW    WWW          WW     WWW          WW    WWW          WW
WAW    g    WAW    WAW    g    WAW     WAW    g    WAW    WAW    g    WAW
mmmmmmmmmmmmmmm    mmmmmmmmmmmmmmm     mmmmmmmmmmmmmmm    mmmmmmmmmmmmmmm
W      A      W    W      A      W     W      A      W    W      A      W
LLLLLLLLLLLLLLL    LLLLLLLLLLLLLLL     LLLLLLLLLLLLLLL    LLLLLLLLLLLLLLL
