LLLLLLLLLLLLLLLLLLLLLLL
L                     L
L          A          L
mmmmmmmmmmmmmmmmmmmmmmm
WAW         g       WAW
WW                   WW
g          aaa       gW
W                     W
WW                   WW
WAW         g       WAW
mmmmmmmmmmmmmmmmmmmmmmm
L                     L
L          A          L
LLLLLLLLLLLLLLLLLLLLLLL
