WWWWWWWWWWWWWWWWWWWWWWWWWWWWWWWWWWWWWWWWWWWWWWWWWWWWWWWWWWWW
W                        g  a     W     W                m W
W   g     W     W                WAmmmmmAW            a    m
W        WAmmmmmAW                m  L  m                  m
W         m     m   a             m     m                  m
W   a     m  L  m                 m  A  m             m    m
W         m  A  m                WAmmmmmAW                 W
W        WAmmmmmAW                W     W             a    W
W   a     W     W                                          W
W                                                          m
W m                          g                  m          m
W             g                        a                   W
W                                                          W
W    g                 a    g                              W
W                                 W     W                  m
W         W     W                WAmmmmmAW                 m
W        WAmmmmmAW                m  L  m              a   W
W         m     m  a              m     m    a             W
W         m  L  m                 m  A  m                  W
W         m  A  m                WAmmmmmAW                 g
W        WAmmmmmAW                W     W    g             g
W         W     W                                          W
W                  g                                      mW
W      a                       L                           W
W                                          a               W
W           g                                        a     W
W  a                                                       W
W                m         m             m          m      W
WWWWWWWWWWWWWWWWWWWWWWWWWWWWWWWWWWWWWWWWWWWWWWWWWWWWWWWWWWWW
WWWWWWWWWWWWWWWWWWWWWWWWWWWWWWWWWWWWWWWWWWWWWWWWWWWWWWWWWWWW
W                        g  a     W     W                  W
W   g     W     W                WAmmmmmAW            a    W
W        WAmmmmmAW                m  L  m                  W
W         m     m   a             m     m                  W
W   a     m  L  m                 m  A  m             m    W
W         m  A  m                WAmmmmmAW                 W
W        WAmmmmmAW                W     W             a    W
W   a     W     W                                          W
W                                                          W
W                           g                   m          W
W             g                        a                   W
W                                                          W
W    g                 a    g                              W
W                                 W     W                  W
W         W     W                WAmmmmmAW                 W
W        WAmmmmmAW                m  L  m              a   W
W         m     m  a              m     m    a             W
W         m  L  m                 m  A  m                  W
W         m  A  m                WAmmmmmAW                 W
W        WAmmmmmAW                W     W    g             W
W         W     W                                          W
W                  g                                      mW
W      a                       L                           W
W                                          a               W
W           g                                        a     W
W  a                                                       W
W                m         m             m          m      W
WWWWWWWWWWWWWWWWWWWWWWWWWWWWWWWWWWWWWWWWWWWWWWWWWWWWWWWWWWWW