WWWWWWWWWWWWWWWWWWWWWWWWWWWWWWWWWW
W                                W
W       WWW              WWWWW   W
W        g                 m     W
W       WWW              WWWWW   W
W                                W
W                  W   W         W
WWW                W a W         W
W m                W   W         W
WWW                              W
W         A                      W
W      WWWWWW                    W
W         a                      W
W      WWWWWW                    W
W                      W    W    W
W                      W  m W    W
W   WWWWW              W    W    W
W    a        W   W              W
W   WWWWW     W m W              W
W             W   W              W
W                                W
W           WWWWWW               W
W                                W
W             g                  W
W           WWWWWW               W
W                                W
W                                W
WWWWWWWWWWWWWWWWWWWWWWWWWWWWWWWWWW
WWWWWWWWWWWWWWWWWWWWWWWWWWWWWWWWWWWWWWWW
W                                      W
W                                      W
W             WWW              WWWWW   W
W              g                 m     W
W             WWW              WWWWW   W
W                                      W
W                                      W
W                  W W                 W
W                  WaW                 W
W                  W W                 W
W                                      W
W                                      W
W                                      W
W         A                            W
W                                      W
W      WWWWWWWWWWW                     W
W         a                            W
W      WWWWWWWWWWW                     W
W                            W W       W
W                            W W       W
W                            WmW       W
W                            W W       W
W             W W            W W       W
W             WmW                      W
W             W W                      W
W                                      W
W                                      W
W                                      W
W           WWWWWWWWWWWWWWWWW          W
W                   g                  W
W                                      W
W           WWWWWWWWWWWWWWWWW          W
W                                      W
W                                      W
W                                      W
W                                      W
WWWWWWWWWWWWWWWWWWWWWWWWWWWWWWWWWWWWWWWW