WWWWWWWWWWWWWWWWWWWWWWWWWWWWWWWWWWWWWWWW
W                                      W
W                                      W
W             WWW              WWWWW   W
W              g                 m     W
W             WWW              WWWWW   W
W                                      W
W                                      W
W                  W W                 W
W                  WaW                 W
W                  W W                 W
W                                      W
W                                      W
W                                      W
W         A                            W
W                                      W
W      WWWWWWWWWWW                     W
W         a                            W
W      WWWWWWWWWWW                     W
W                            W W       W
W                            W W       W
W                            WmW       W
W                            W W       W
W             W W            W W       W
W             WmW                      W
W             W W                      W
W                                      W
W                                      W
W                                      W
W           WWWWWWWWWWWWWWWWW          W
W                   g                  W
W                                      W
W           WWWWWWWWWWWWWWWWW          W
W                                      W
W                                      W
W                                      W
W                                      W
WWWWWWWWWWWWWWWWWWWWWWWWWWWWWWWWWWWWWWWW
WWWWWWWWWWWWWWWWWWWWWWWWWWWWWWWWWWWWWWWW
W                                      W
W                                      W
W             WWW              WWWWW   W
W              g                 m     W
W             WWW              WWWWW   W
W                                      W
W                                      W
W                  W W                 W
W                  WaW                 W
W                  W W                 W
W                                      W
W                                      W
W                                      W
W         A                            W
W                                      W
W      WWWWWWWWWWW                     W
W         a                            W
W      WWWWWWWWWWW                     W
W                            W W       W
W                            W W       W
W                            WmW       W
W                            W W       W
W             W W            W W       W
W             WmW                      W
W             W W                      W
W                                      W
W                                      W
W                                      W
W           WWWWWWWWWWWWWWWWW          W
W                   g                  W
W                                      W
W           WWWWWWWWWWWWWWWWW          W
W                                      W
W                                      W
W                                      W
W                                      W
WWWWWWWWWWWWWWWWWWWWWWWWWWWWWWWWWWWWWWWW