            WWWWWWWWW                             WWWWWWWW
            W       W                             W      W
            W       W                             W      W
            W       W                             W      W
            W       W                             W      W
            W       W                             W      W
            W       W                             W      W
            W       W                             W      W
            W       W                             W      W
            W       W                             W      W
            W       W                             W      W
            W       W                             W      W 
            W       W                             W      W                                                       W
WWWWWWWWWWWWW       WWWWWWWWWWWWWWWWWWWWWWWWWWWWWWW      WWWWWWWWWWWWWWWWW                           W      W                                                        W 
W                                                                      W 
W                                                                      W 
W                                                                      W 
W                                                                      W
W                                                                      W                                           W
WWWWWWWWWWWWW                                           WWWWWWWWWWWWWWWW
            W                                           W
            W                                           W
            W                                           W
            W                                           W
            W                                           W
            W                                           W
            W                                           W
            W                                           W
            W                                           W 
            W                                           W
            W                                           W
            W                                           W
            W                                           W
            W                                           W
            W                                           W
WWWWWWWWWWWWW                                           WWWWWWWWWWWWWWWW                                          
W                                                                      W 
W                                                                      W 
W                                                                      W 
W                                                                      W
WWWWWWWWWWWWW     WWWWWWWWWWWWWWWWWWWWWWWWWWWWWWW       WWWWWWWWWWWWWWWW  
            W     W                             W      W
            W     W                             W      W
            W     W                             W      W
            W     W                             W      W
            W     W                             W      W
            W     W                             W      W
            W     W                             W      W
            W     W                             W      W
            W     W                             W      W
            W     W                             W      W
            W     W                             W      W 
            W     W                             W      W   
            W     W                             W      W
            WWWWWWW                             WWWWWWWW