            WWWWWWW                             WWWWWWWW
            W     W                             W      W
            W     W                             W      W
            W     W                             W      W
            W     W                             W      W
            W     W                             W      W
            W     W                             W      W
            W     W                             W      W
            W     W                             W      W
            W     W                             W      W
            W     W                             W      W
WWWWWWWWWWWWW     WWWWWWWWWWWWWWWWWWWWWWWWWWWWWWW      WWWWWWWWWWWWWWW
W                                                                    W
W                                                                    W 
W                                                                    W 
W                                                                    W
WWWWWWWWWWWWW      WWWWWWWWWWWWWWWWWWWWWWWWWWWWW        WWWWWWWWWWWWWW
            W      W                           W        W
            W      W                           W        W
            W      W                           W        W
            W      W                           W        W
            W      W                           W        W
            W      W                           W        W
            W      W                           W        W
            W      W                           W        W
            W      W                           W        W
            W      W                           W        W
            W      W                           W        W
            W      W                           W        W
            W      W                           W        W
WWWWWWWWWWWWW      WWWWWWWWWWWWWWWWWWWWWWWWWWWWW        WWWWWWWWWWWWWW 
W                                                                    W
W                                                                    W 
W                                                                    W 
W                                                                    W
WWWWWWWWWWWWW      WWWWWWWWWWWWWWWWWWWWWWWWWWWWW        WWWWWWWWWWWWWW
            W      W                           W        W
            W      W                           W        W
            W      W                           W        W
            W      W                           W        W
            W      W                           W        W
            W      W                           W        W
            W      W                           W        W
            W      W                           W        W
            W      W                           W        W
            W      W                           W        W
            W      W                           W        W
            WWWWWWWW                           WWWWWWWWWW