WWWWWWWWWWWWWWWWWWWWWWWWWWWWWWWW
W  W a  W  W   m    W  W    W  W
W  W    W  W        W  W    W  W
W  W    W  W        W  W    W  W
W  W    W  W        W  W    W  W
WWWW    WWWW        WWWW    WWWW
W          W        W          W
W A       mW        W          W
W          W        W          W
WWWW    WWWW        WWWW    WWWW
W  W    W  W        W  W    W  W
W  W    W  W        W  W    W  W
W  W g  W  W        W  W    W  W
WWWWWWWWWWWW        WWWWWWWWWWWW
W                              W
W                              W
W  g                        a  W
W                              W
W                              W
WWWWWWWWWWWW        WWWWWWWWWWWW
W  W a  W  W        W  W    W  W
W  W    W  W        W  W    W  W
W  W    W  W        W  W    W  W
W  W    W  W        W  W    W  W
WWWW    WWWW        WWWW    WWWW
W          W        W          W
W A       mW        W          W
W          W        W          W
WWWW    WWWW        WWWW    WWWW
W  W    W  W        W  W    W  W
W  W    W  W        W  W    W  W
W  W g  W  W   A    W  W    W  W
WWWWWWWWWWWWWWWWWWWWWWWWWWWWWWWW