            WWWWWWW             
            W     W              
            W     W             
            W     W             
            W     W             
            W     W             
            W     W             
            W     W             
            W     W             
            W     W             
            W     W             
WWWWWWWWWWWWW     WWWWWWWWWWWWWW
W                              W
W  g                        a  W 
W                              W 
W                              W
WWWWWWWWWWWWW      WWWWWWWWWWWWW
            W      W            
            W      W            
            W      W            
            W      W            
            W      W            
            W      W            
            W      W            
            W   A  W              
            W      W             
            WWWWWWWW                    