WWWWWWWWWWWWWWWWWWWWWWWWWWWWWW
W                            W
W                            W
W   WWWWWWWWWWWWW            W
W   W       W m W            W
W   W       W   W     A      W
W   W   W       W            W
W   W   W       W            W
W   W   WWWWWWWWW            W
W                            W
W                            W
W             WWWWWW   W     W
W             W        W     W
W             W        W     W
W             W  WWWWWWW     W
W             W      g W     W
W             WWWWWWWWWW     W
W                            W
W                            W
W   WWW   WWWW               W
W   W     Wa W               W
W   W  WW W  W               W
W   W        W               W
W   W   WWWWWW               W
W   W                        W
W   WWWWWWWWWW               W
W                            W
W                            W
WWWWWWWWWWWWWWWWWWWWWWWWWWWWWW
WWWWWWWWWWWWWWWWWWWWWWWWWWWWWW
W                            W
W                            W
W   WWWWWWWWWWWWW            W
W   W       W m W            W
W   W       W   W     A      W
W   W   W       W            W
W   W   W       W            W
W   W   WWWWWWWWW            W
W                            W
W                            W
W             WWWWWW   W     W
W             W        W     W
W             W        W     W
W             W  WWWWWWW     W
W             W      g W     W
W             WWWWWWWWWW     W
W                            W
W                            W
W   WWW   WWWW               W
W   W     Wa W               W
W   W  WW W  W               W
W   W        W               W
W   W   WWWWWW               W
W   W                 A      W
W   WWWWWWWWWW               W
W                            W
W                            W
WWWWWWWWWWWWWWWWWWWWWWWWWWWWWW