WWWWWWWWWWWW          
W          W          
W          W          
W   a    g W          
W          W          
W          W          
W          W          
W          W          
W   A   m  W          
W          W          
W          W          
W          W          
WWWWWWWWWWWW          
WWWWWWWWWWWWWWWWWWWWWW
W                    W
W                    W
W   a                W
W             g      W
W                    W
W                    W
W                    W
W   A          m     W
W                    W
W                    W
WWWWWWWWWWWWWWWWWWWWWW