WWWWWWWWWWWWWWWWWWWWWWWWWWWWWWWWWWWWWWWWWWWWWWWWWWWWWWWWWWWWWWWWWWWWWWWWWWWWWWWWWWWWWWWWWWWWWWWWWWWWWWWWWWWWWWWWWWWWWWWWWWWWWWWWWWWWWWWWWW
W g a W  A W     W       W                W    W          W     W                    W     W            W         W            W         W
W     W    W     W       W  a             W    W          W     W                    W     W  A         W         W A          W         W
W     W    W     W       W                W    W   a    g W     W   a                W     W          a W         W          m W         W
W     W    W     W       WWWWWW           W    W          W     W             g      W     W            W         W            W         W
W     W    W     W       W            m   W    W          W     W                    W     WWWW      WWWW         WWWWW        W         W
W     W    W     W       W A              W    W          W     W                    W     W            W         W        WWWWW         W
W                W       WWWWW            W    W          W     W                    W     W        g   W         W  g         W         W
W                W       W g              W    W m      A W     W   A          m     W     W  m         W         W         a  W         W
W       m        W       W                W    W          W     W                    W     W            W         W            W         W
WWWWWWWWWWWWWWWWWW       WWWWWWWWWWWWWWWWWW    WWWWWWWWWWWW     WWWWWWWWWWWWWWWWWWWWWW     WWWWWWWWWWWWWW         WWWWWWWWWWWWWW         W
W                                                                                                                                        W
W                                                                                                                                        W
W                                                                                                               WWWWWWWWWWWWWWWWWWWWWWWWWW
W                                 WWWWWWWWWWWWWWWWWWWWWWWWWWWWWWWW        WWWWWWWWWWWWWWWWWWWWWWWWWWWWWWWWWW    W                 W      W
WWWWWWWWWWWWWWWWWWWWWWWWWWWWWW    W  W a  W  W   m    W  W  a W  W        W                                W    W                 W      W
W                            W    W  W    W  W        W  W    W  W        W       WWW              WWWWW   W    W      a W        W      W
W                     b      W    W  W    W  W        W  W    W  W        W        g                 m     W    W        W        W      W
W           A                W    W  W    W  W        W  W    W  W        W       WWW              WWWWW   W    W      WWWWWW     W      W
W       b     g              W    WWWW    WWWW        WWWW    WWWW        W                                W    W     m  W        W      W
W                            W    W          W        W          W        W                  W   W         W    W        W  g     W      W
W                 b          W    W A       mW        Wg       m W        WWW                W a W         W    W    A            W      W
W       g                    W    W          W        W          W        W m                W   W         W    W                 W      W
W                     a      W    WWWW    WWWW        WWWW    WWWW        WWW                              W    WWWWWWWWWWWWWWWWWWWWWWWWWW
W           b                W    W  W    W  W        W  W    W  W        W         A                      W    W                        W
W                            W    W  W    W  W        W  W    W  W        W      WWWWWW                    W    W                        W
W                            W    W  W g  W  W        W  W A  W  W        W         a                      W    W       WWWWWWWWWWWWWWWWWW
W        b          b        W    WWWWWWWWWWWW        WWWWWWWWWWWW        W      WWWWWW                    W    W       W        W       W
W              A             W    W                              W        W                      W    W    W    W       W   a    W       W
W                            W    W                              W        W                      W  m W    W    W       W        W  g    W
W              a             W    W  g                        a  W        W   WWWWW              W    W    W    W       W                W
W     b             b        W    W                              W        W    a        W   W              W    W       WWWWWW       WWWWW
W                            W    W                              W        W   WWWWW     W m W              W    W       W                W
W                            W    WWWWWWWWWWWW        WWWWWWWWWWWW        W             W   W              W    W       W        W    m  W
W       m                    W    W  W a  W  W        W  W  A W  W        W                                W    W       W    A   W       W
W                      m     W    W  W    W  W        W  W    W  W        W           WWWWWW               W    W       W        W       W
W           b                W    W  W    W  W        W  W    W  W        W                                W    W       W        W       W
W                   b        W    W  W    W  W        W  W    W  W        W             g                  W    WWWWWWWWWWWWWWWWWWWWWWWWWW
W          g                 W    WWWW    WWWW        WWWW    WWWW        W           WWWWWW               W                             W
W                            W    W          W        W          W        W                                W                             W
WWWWWWWWWWWWWWWWWWWWWWWWWWWWWW    W A       mW        Wm       g W        WWWWWWWWWWWWWWWWWWWWWWWWWWWWWWWWWW                             W
W                                 W          W        W          W        W                                W                             W
W                                 WWWW    WWWW        WWWW    WWWW        W                                W                             W
W                                 W  W    W  W        W  W    W  W        W                                W                             W
W                                 W  W    W  W        W  W    W  W        W                                W                             W
W                                 W  W g  W  W   A    W  W a  W  W        W                                W                             W
WWWWWWWWWWWWWWWWWWWWWWWWWWWWWWWWWWWWWWWWWWWWWWWWWWWWWWWWWWWWWWWWWWWWWWWWWWWWWWWWWWWWWWWWWWWWWWWWWWWWWWWWWWWWWWWWWWWWWWWWWWWWWWWWWWWWWWWWWW