WWWWWWWWWWWWWWWWWW
W                W
W   A         g  W
W                W
W                W
W                W
W        WWWWWWWWW
W                W
W                W
W   m        a   W
W                W
W                W
W                W
WWWWWWWWWWWWWWWWWW
WWWWWWWWWWWWWWWWWW
W                W
W   A         g  W
W                W
W                W
W                W
W        WWWWWWWWW
W                W
W                W
W   m        a   W
W                W
W                W
W                W
WWWWWWWWWWWWWWWWWW
