WWWWWWWWWWWWWWWWWWWWWWWWWWWWWW
W                            W
W                            W
W           A                W
W             g              W
W                            W
W                 b          W
W       g                    W
W                            W
W                            W
W                            W
W                            W
W                            W
W              A             W
W                            W
W                            W
W              a             W
W                   b        W
W                            W
W                            W
W       m                    W
W                      m     W
W                            W
W                   b        W
W          g                 W
W                            W
WWWWWWWWWWWWWWWWWWWWWWWWWWWWWW