WWWWWWWWWWWWWWW
W             W
W             W
W   a    g    W
W             W
W             W
W             W
WWWWW     WWWWW
W             W
W             W
W   A      m  W
W             W
W             W
W             W
WWWWWWWWWWWWWWW
WWWWWWWWWWWWWWW
W             W
W             W
W   a    g    W
W             W
W             W
W             W
WWWWW    WWWWWW
W             W
W             W
W   A      m  W
W             W
W             W
W             W
WWWWWWWWWWWWWWW