WWWWWWWWWWWWWWWWWWWWWWWWWWWWWW
W                            W
W                     b      W
W           A                W
W       b     g              W
W                            W
W                 b          W
W       g                    W
W                     a      W
W           b                W
W                            W
W                            W
W        b          b        W
W              A             W
W                            W
W                            W
W              a             W
W     b             b        W
W                            W
W                            W
W       m                    W
W                      m     W
W           b                W
W                   b        W
W          g                 W
W                            W
WWWWWWWWWWWWWWWWWWWWWWWWWWWWWW