WWWWWWWWWWWWWWWWWWWWWWWWWW
W                 W      W
W                 W      W
W      a W        W      W
W        W        W      W
W      WWWWWW     W      W
W     m  W        W      W
W        W  g     W      W
W    A            W      W
W                 W      W
WWWWWWWWWWWWWWWWWWW      W
W                        W
W                        W
W       WWWWWWWWWWWWWWWWWW
W       W        W       W
W       W   a    W       W
W       W        W  g    W
W       W                W
W       WWWWWW       WWWWW
W       W                W
W       W        W    m  W
W       W    A   W       W
W       W        W       W
WWWWWWWWWWWWWWWWWWWWWWWWWW