W                                                                                                          W
W                                 WWWWWWWWWWWWWWWWWWWWWWWWWWWWWWWW        WWWWWWWWWWWWWWWWWWWWWWWWWWWWWWWWWW
WWWWWWWWWWWWWWWWWWWWWWWWWWWWWW    W  W a  W  W   m    W  W  a W  W        W                                W
W                            W    W  W    W  W        W  W    W  W        W       WWW              WWWWW   W
W                     b      W    W  W    W  W        W  W    W  W        W        g                 m     W
W           A                W    W  W    W  W        W  W    W  W        W       WWW              WWWWW   W
W       b     g              W    WWWW    WWWW        WWWW    WWWW        W                                W
W                            W    W          W        W          W        W                  W   W         W
W                 b          W    W A       mW        Wg       m W        WWW                W a W         W
W       g                    W    W          W        W          W        W m                W   W         W
W                     a      W    WWWW    WWWW        WWWW    WWWW        WWW                              W
W           b                W    W  W    W  W        W  W    W  W        W         A                      W
W                            W    W  W    W  W        W  W    W  W        W      WWWWWW                    W
W                            W    W  W g  W  W        W  W A  W  W        W         a                      W
W        b          b        W    WWWWWWWWWWWW        WWWWWWWWWWWW        W      WWWWWW                    W
W              A             W    W                              W        W                      W    W    W
W                            W    W                              W        W                      W  m W    W
W              a             W    W  g                        a  W        W   WWWWW              W    W    W
W     b             b        W    W                              W        W    a        W   W              W
W                            W    W                              W        W   WWWWW     W m W              W
W                            W    WWWWWWWWWWWW        WWWWWWWWWWWW        W             W   W              W
W       m                    W    W  W a  W  W        W  W  A W  W        W                                W
W                      m     W    W  W    W  W        W  W    W  W        W           WWWWWW               W
W           b                W    W  W    W  W        W  W    W  W        W                                W
W                   b        W    W  W    W  W        W  W    W  W        W             g                  W
W          g                 W    WWWW    WWWW        WWWW    WWWW        W           WWWWWW               W
W                            W    W          W        W          W        W                                W
WWWWWWWWWWWWWWWWWWWWWWWWWWWWWW    W A       mW        Wm       g W        WWWWWWWWWWWWWWWWWWWWWWWWWWWWWWWWWW
W                                 W          W        W          W        W                                W
W                                 WWWW    WWWW        WWWW    WWWW        W                                W
W                                 W  W    W  W        W  W    W  W        W                                W
W                                 W  W    W  W        W  W    W  W        W                                W
W                                 W  W g  W  W   A    W  W a  W  W        W                                W
WWWWWWWWWWWWWWWWWWWWWWWWWWWWWWWWWWWWWWWWWWWWWWWWWWWWWWWWWWWWWWWWWWWWWWWWWWWWWWWWWWWWWWWWWWWWWWWWWWWWWWWWWWWW




WWWWWWWWWWWWWWWWWWWWWWWWWW
W                 W      W
W                 W      W
W      a W        W      W
W        W        W      W
W      WWWWWW     W      W
W     m  W        W      W
W        W  g     W      W
W    A            W      W
W                 W      W
WWWWWWWWWWWWWWWWWWW      W
W                        W
W                        W
W       WWWWWWWWWWWWWWWWWW
W       W        W       W
W       W   a    W       W
W       W        W  g    W
W       W                W
W       WWWWWW       WWWWW
W       W                W
W       W        W    m  W
W       W    A   W       W
W       W        W       W
WWWWWWWWWWWWWWWWWWWWWWWWWW