WWWWWWWWWWWWWWWWWWWW
W                  W
W                  W
W   T              W
W                  W
W                  W
W                  W
W                  W
W                  W
W                  W
WWWWWWWWWWWWWWWWWWWW
W                  W
W   T          a   W
W                  W
W                  W
W                  W
W                  W
W   m          g   W
W                  W
WWWWWWWWWWWWWWWWWWWW