WWWWWaaaaaWWWWWWWWWWaaALaWWWWWWWWWWaaaaaWWWWWWWWWW
WWWLg     mLWWWWWWLm  a  gLWWWWWWWm     gWWWWWWWWW
WWWAg     mAWWWWWWAm     gAWWWWWWWm     gWWWWWWWWW
WWWWW     WLWWWWWWWW     WWWWWWWWWW     WWWWWWWWWW
WWWWW     WAWWWWWWWW     WWWWWWWWWW     WWWWWWWWWW
WWWWW A   WWWWWWWWWW     WWWWWWWWWW     WWWWWWWWWW
WWWWW     WWWWWWWWWW     WWWWWWWWWW     WWWWWWWWWW
WWWWW    LWWWWWWWWWW    LWWWWWWWWWW     WWWWWWWWWW
WWWWW     WWWWWWWWWW     WWWWWWWWWW     WWWWWWWWWW

WWWWW     WWWWWWWWWW     WWWWWWWWWW     WWWWWWWWWW
WWWWW     WWWWWWWWWW     WWWWWWWWWW    LWWWWWWWWWW
WWWWW     WWWWWWWWWW     WWWWWWWWWW     WWWWWWWWWW
WWWWW     WWWWWWWWWW     WWWWWWWWWW     WWWWWWWWWW
WWWWW     WWWWWWWWWW     WWWWWWWWWW     WWWWWWWWWW
WWWWm     gWWWWWWWWm     gWWWWWWWAg     mAWWWWWWWW
WWWWm     gWWWWWWWWm     gWWWWWWW:g     mLWWWWWWWW
WWWWWaaaaaWWWWWWWWWWaaaaaWWWWWWWWWWaaaaaWWWWWWWWWW
WWWWWWWWWWWWWWWWWWWWWWWWWWWWWWWWWWWWWWWWWWWWWWWWWW
WWWWWWWWWWWWWWWWWWWWWWWWWWWWWWWWWWWWWWWWWWWWW
WWWWWWWWWWWWWWWWWWWWWWWWWWWWWWWWWWWWWWWWWWWWW
WWWWWWWWWWWWWWWWWWWWWWWWWWWWWWWWWWWWWWWWWWWWW
WWWWW     WWWWWWWWWW     WWWWWWWWWW     WWWWW
WWWWW     WWWWWWWWWW     WWWWWWWWWW     WWWWW 
WWWWW     WWWWWWWWWW     WWWWWWWWWW     WWWWW 
WWWWW     WWWWWWWWWW     WWWWWWWWWW     WWWWW 
WWWWW     WWWWWWWWWW     WWWWWWWWWW     WWWWW 
WWWWW     WWWWWWWWWW     WWWWWWWWWW     WWWWW 
WWWWW     WWWWWWWWWW     WWWWWWWWWW     WWWWW 
WWWWW     WWWWWWWWWW     WWWWWWWWWW     WWWWW 

    WWWWW     WWWWWWWWWW     WWWWWWWWWW     WWWWWWWWW
    WWWWW     WWWWWWWWWW     WWWWWWWWWW     WWWWWWWWW
    WWWWW     WWWWWWWWWW     WWWWWWWWWW     WWWWWWWWW
    WWWWW     WWWWWWWWWW     WWWWWWWWWW     WWWWWWWWWW
    WWWWW     WWWWWWWWWW     WWWWWWWWWW     WWWWW
    WWWWW     WWWWWWWWWW     WWWWWWWWWW     WWWWW
    WWWWW     WWWWWWWWWW     WWWWWWWWWW     WWWWW
    WWWWWWWWWWWWWWWWWWWWWWWWWWWWWWWWWWWWWWWWWWWWW
    WWWWWWWWWWWWWWWWWWWWWWWWWWWWWWWWWWWWWWWWWWWWWW
    W     WWWWWWWWWW     WWWWWWWWWW     WWWWWWWWWW
    W     WWWWWWWWWW     WWWWWWWWWW     WWWWWWWWWW
    W     WWWWWWWWWW     WWWWWWWWWW     WWWWWWWWWW
    W     WWWWWWWWWW     WWWWWWWWWW     WWWWWWWWWW
    W     WWWWWWWWWW     WWWWWWWWWW     WWWWWWWWWW
    W     WWWWWWWWWW     WWWWWWWWWW     WWWWWWWWWW
    W     WWWWWWWWWW     WWWWWWWWWW     WWWWWWWWWW
    W     WWWWWWWWWW     WWWWWWWWWW     WWWWWWWWWW
A
WWWWW     WWWWWWWWWW     WWWWWWWWWW     WWWWW
WWWWW     WWWWWWWWWW     WWWWWWWWWW     WWWWW
WWWWW     WWWWWWWWWW     WWWWWWWWWW     WWWWW
WWWWW     WWWWWWWWWW     WWWWWWWWWW     WWWWW
WWWWW     WWWWWWWWWW     WWWWWWWWWW     WWWWW
WWWWW     WWWWWWWWWW     WWWWWWWWWW     WWWWW
WWWWW     WWWWWWWWWW     WWWWWWWWWW     WWWWW
WWWWWWWWWWWWWWWWWWWWWWWWWWWWWWWWWWWWWWWWWWWWW
WWWWWWWWWWWWWWWWWWWWWWWWWWWWWWWWWWWWWWWWWWWWW
WWWWWWWWWWWWWWWWWWWWWWWWWWWWWWWWWWWWWWWWWWWWW