WWWWWaaaaaWWWWWWWWWWaaALaWWWWWWWWWWaaaaaWWWWWWWWaaaaaWWWWWWWWWWaaALaWWWWWWWWWWaaaaaWWWWWWWWaaaaaWWWWWWWWWWaaALaWWWWWWWWWWaaaaaWWWWWWWWaaaaaWWWWWWWWWWaaALaWWWWWWWWWWaaaaaWWWWWWWWaaaaaWWWWWWWWWWaaALaWWWWWWWWWWaaaaaWWWWWWWWaaaaaWWWWWWWWWWaaALaWWWWWWWWWWaaaaaWWWWWWWWaaaaaWWWWWWWWWWaaALaWWWWWWWWWWaaaaaWWWWWWWWaaaaaWWWWWWWWWWaaALaWWWWWWWWWWaaaaaWWW
WWWLg     mLWWWWWWLm  a  gLWWWWWWWm     gWWWWWLg     mLWWWWWWLm  a  gLWWWWWWWm     gWWWWWLg     mLWWWWWWLm  a  gLWWWWWWWm     gWWWWWLg     mLWWWWWWLm  a  gLWWWWWWWm     gWWWWWLg     mLWWWWWWLm  a  gLWWWWWWWm     gWWWWWLg     mLWWWWWWLm  a  gLWWWWWWWm     gWWWWWLg     mLWWWWWWLm  a  gLWWWWWWWm     gWWWWWLg     mLWWWWWWLm  a  gLWWWWWWWm     gWW
WWWAg     mAWWWWWWAm     gAWWWWWWWm     gWWWWWAg     mAWWWWWWAm     gAWWWWWWWm     gWWWWWAg     mAWWWWWWAm     gAWWWWWWWm     gWWWWWAg     mAWWWWWWAm     gAWWWWWWWm     gWWWWWAg     mAWWWWWWAm     gAWWWWWWWm     gWWWWWAg     mAWWWWWWAm     gAWWWWWWWm     gWWWWWAg     mAWWWWWWAm     gAWWWWWWWm     gWWWWWAg     mAWWWWWWAm     gAWWWWWWAm     gAW
WWWWW     WLWWWWWWWW     WWWWWWWWWW     WWWWWWWW     WLWWWWWWWW     WWWWWWWWWW     WWWWWWWW     WLWWWWWWWW     WWWWWWWWWW     WWWWWWWW     WLWWWWWWWW     WWWWWWWWWW     WWWWWWWW     WLWWWWWWWW     WWWWWWWWWW     WWWWWWWW     WLWWWWWWWW     WWWWWWWWWW     WWWWWWWW     WLWWWWWWWW     WWWWWWWWWW     WWWWWWWW     WLWWWWWWWW     WWWWWWWWWW     WWW
WWWWW     WAWWWWWWWW     WWWWWWWWWW     WWWWWWWW     WAWWWWWWWW     WWWWWWWWWW     WWWWWWWW     WAWWWWWWWW     WWWWWWWWWW     WWWWWWWW     WAWWWWWWWW     WWWWWWWWWW     WWWWWWWW     WAWWWWWWWW     WWWWWWWWWW     WWWWWWWW     WAWWWWWWWW     WWWWWWWWWW     WWWWWWWW     WAWWWWWWWW     WWWWWWWWWW     WWWWWWWW     WAWWWWWWWW     WWWWWWWWWW     WWW
WWWWW     WWWWWWWWWW     WWWWWWWWWW     WWWWWWWW     WWWWWWWWWW     WWWWWWWWWW     WWWWWWWW     WWWWWWWWWW     WWWWWWWWWW     WWWWWWWW     WWWWWWWWWW     WWWWWWWWWW     WWWWWWWW     WWWWWWWWWW     WWWWWWWWWW     WWWWWWWW     WWWWWWWWWW     WWWWWWWWWW     WWWWWWWW     WWWWWWWWWW     WWWWWWWWWW     WWWWWWWW     WWWWWWWWWW     WWWWWWWWWW     WWW
WWWWW     WWWWWWWWWW     WWWWWWWWWW     WWWWWWWW     WWWWWWWWWW     WWWWWWWWWW     WWWWWWWW     WWWWWWWWWW     WWWWWWWWWW     WWWWWWWW     WWWWWWWWWW     WWWWWWWWWW     WWWWWWWW     WWWWWWWWWW     WWWWWWWWWW     WWWWWWWW     WWWWWWWWWW     WWWWWWWWWW     WWWWWWWW     WWWWWWWWWW     WWWWWWWWWW     WWWWWWWW     WWWWWWWWWW     WWWWWWWWWW     WWW
WWWWW    LWWWWWWWWWW    LWWWWWWWWWW     WWWWWWWW    LWWWWWWWWWW    LWWWWWWWWWW     WWWWWWWW    LWWWWWWWWWW    LWWWWWWWWWW     WWWWWWWW    LWWWWWWWWWW    LWWWWWWWWWW     WWWWWWWW    LWWWWWWWWWW    LWWWWWWWWWW     WWWWWWWW    LWWWWWWWWWW    LWWWWWWWWWW     WWWWWWWW    LWWWWWWWWWW    LWWWWWWWWWW     WWWWWWWW    LWWWWWWWWWW    LWWWWWWWWWW     WWW
WWWWW     WWWWWWWWWW     WWWWWWWWWW     WWWWWWWW     WWWWWWWWWW     WWWWWWWWWW     WWWWWWWW     WWWWWWWWWW     WWWWWWWWWW     WWWWWWWW     WWWWWWWWWW     WWWWWWWWWW     WWWWWWWW     WWWWWWWWWW     WWWWWWWWWW     WWWWWWWW     WWWWWWWWWW     WWWWWWWWWW     WWWWWWWW     WWWWWWWWWW     WWWWWWWWWW     WWWWWWWW     WWWWWWWWWW     WWWWWWWWWW     WWW

WWWWW     WWWWWWWWWW     WWWWWWWWWW     WWWWWWWW     WWWWWWWWWW     WWWWWWWWWW     WWWWWWWW     WWWWWWWWWW     WWWWWWWWWW     WWWWWWWW     WWWWWWWWWW     WWWWWWWWWW     WWWWWWWW     WWWWWWWWWW     WWWWWWWWWW     WWWWWWWW     WWWWWWWWWW     WWWWWWWWWW     WWWWWWWW     WWWWWWWWWW     WWWWWWWWWW     WWWWWWWW     WWWWWWWWWW     WWWWWWWWWW     WWW
WWWWW     WWWWWWWWWW     WWWWWWWWWW    LWWWWWWWW     WWWWWWWWWW     WWWWWWWWWW    LWWWWWWWW     WWWWWWWWWW     WWWWWWWWWW    LWWWWWWWW     WWWWWWWWWW     WWWWWWWWWW    LWWWWWWWW     WWWWWWWWWW     WWWWWWWWWW    LWWWWWWWW     WWWWWWWWWW     WWWWWWWWWW    LWWWWWWWW     WWWWWWWWWW     WWWWWWWWWW    LWWWWWWWW     WWWWWWWWWW     WWWWWWWWWW     WWW
WWWWW     WWWWWWWWWW     WWWWWWWWWW     WWWWWWWW     WWWWWWWWWW     WWWWWWWWWW     WWWWWWWW     WWWWWWWWWW     WWWWWWWWWW     WWWWWWWW     WWWWWWWWWW     WWWWWWWWWW     WWWWWWWW     WWWWWWWWWW     WWWWWWWWWW     WWWWWWWW     WWWWWWWWWW     WWWWWWWWWW     WWWWWWWW     WWWWWWWWWW     WWWWWWWWWW     WWWWWWWW     WWWWWWWWWW     WWWWWWWWWW     WWW
WWWWW     WWWWWWWWWW     WWWWWWWWWW     WWWWWWWW     WWWWWWWWWW     WWWWWWWWWW     WWWWWWWW     WWWWWWWWWW     WWWWWWWWWW     WWWWWWWW     WWWWWWWWWW     WWWWWWWWWW     WWWWWWWW     WWWWWWWWWW     WWWWWWWWWW     WWWWWWWW     WWWWWWWWWW     WWWWWWWWWW     WWWWWWWW     WWWWWWWWWW     WWWWWWWWWW     WWWWWWWW     WWWWWWWWWW     WWWWWWWWWW     WWW
WWWWW     WWWWWWWWWW     WWWWWWWWWW     WWWWWWWW     WWWWWWWWWW     WWWWWWWWWW     WWWWWWWW     WWWWWWWWWW     WWWWWWWWWW     WWWWWWWW     WWWWWWWWWW     WWWWWWWWWW     WWWWWWWW     WWWWWWWWWW     WWWWWWWWWW     WWWWWWWW     WWWWWWWWWW     WWWWWWWWWW     WWWWWWWW     WWWWWWWWWW     WWWWWWWWWW     WWWWWWWW     WWWWWWWWWW     WWWWWWWWWW     WWW
WWWWm     gWWWWWWWWm     gWWWWWWWAg     mAWWWWWm     gWWWWWWWWm     gWWWWWWWAg     mAWWWWWm     gWWWWWWWWm     gWWWWWWWAg     mAWWWWWm     gWWWWWWWWm     gWWWWWWWAg     mAWWWWWm     gWWWWWWWWm     gWWWWWWWAg     mAWWWWWm     gWWWWWWWWm     gWWWWWWWAg     mAWWWWWm     gWWWWWWWWm     gWWWWWWWAg     mAWWWWWm     gWWWWWWWWm     gWWWWWWWAg     mAW
WWWWm     gWWWWWWWWm     gWWWWWWW:g     mLWWWWWm     gWWWWWWWWm     gWWWWWWW:g     mLWWWWWm     gWWWWWWWWm     gWWWWWWW:g     mLWWWWWm     gWWWWWWWWm     gWWWWWWW:g     mLWWWWWm     gWWWWWWWWm     gWWWWWWW:g     mLWWWWWm     gWWWWWWWWm     gWWWWWWW:g     mLWWWWWm     gWWWWWWWWm     gWWWWWWW:g     mLWWWWWm     gWWWWWWWWm     gWWWWWWW:g     mLW
WWWWWaaaaaWWWWWWWWWWaaaaaWWWWWWWWWWaaaaaWWWWWWWWaaaaaWWWWWWWWWWaaaaaWWWWWWWWWWaaaaaWWWWWWWWaaaaaWWWWWWWWWWaaaaaWWWWWWWWWWaaaaaWWWWWWWWaaaaaWWWWWWWWWWaaaaaWWWWWWWWWWaaaaaWWWWWWWWaaaaaWWWWWWWWWWaaaaaWWWWWWWWWWaaaaaWWWWWWWWaaaaaWWWWWWWWWWaaaaaWWWWWWWWWWaaaaaWWWWWWWWaaaaaWWWWWWWWWWaaaaaWWWWWWWWWWaaaaaWWWWWWWWaaaaaWWWWWWWWWWaaaaaWWWWWWWWWWaaaaaWWW
WWWWWWWWWWWWWWWWWWWWWWWWWWWWWWWWWWWWWWWWWWWWWWWWWWWWWWWWWWWWWWWWWWWWWWWWWWWWWWWWWWWWWWWWWWWWWWWWWWWWWWWWWWWWWWWWWWWWWWWWWWWWWWWWWWWWWWWWWWWWWWWWWWWWWWWWWWWWWWWWWWWWWWWWWWWWWWWWWWWWWWWWWWWWWWWWWWWWWWWWWWWWWWWWWWWWWWWWWWWWWWWWWWWWWWWWWWWWWWWWWWWWWWWWWWWWWWWWWWWWWWWWWWWWWWWWWWWWWWWWWWWWWWWWWWWWWWWWWWWWWWWWWWWWWWWWWWWWWWWWWWWWWWWWWWWWWWWWWWWWWWWW


