WWWWWaaaaaWWWWWWWWWWaaALaWWWWWWWWWWaaaaaWWWWWWWWWW
WWWLg     mLWWWWWWLm  a  gLWWWWWWWm     gWWWWWWWWW
WWWAg     mAWWWWWWAm     gAWWWWWWWm  A  gWWWWWWWWW
WWWWW     WLWWWWWWWW     WWWWWWWWWW     WWWWWWWWWW
WWWWW     WAWWWWWWWW     WWWWWWWWWW     WWWWWWWWWW
WWWWW A   WWWWWWWWWW     WWWWWWWWWW     WWWWWWWWWW
WWWWW     WWWWWWWWWW     WWWWWWWWWW     WWWWWWWWWW
WWWWW    LWWWWWWWWWW    LWWWWWWWWWW     WWWWWWWWWW
WWWWW     WWWWWWWWWW     WWWWWWWWWW     WWWWWWWWWW
W                                                W
WWWWW     WWWWWWWWWW     WWWWWWWWWW     WWWWWWWWWW
WWWWW     WWWWWWWWWW     WWWWWWWWWW    LWWWWWWWWWW
WWWWW     WWWWWWWWWW     WWWWWWWWWW     WWWWWWWWWW
WWWWW     WWWWWWWWWW     WWWWWWWWWW     WWWWWWWWWW
WWWWW     WWWWWWWWWW     WWWWWWWWWW     WWWWWWWWWW
WWWWm     gWWWWWWWWm     gWWWWWWWAg     mAWWWWWWWW
WWWWm     gWWWWWWWWm     gWWWWWWW:g     mLWWWWWWWW
WWWWWaaaaaWWWWWWWWWWaaaaaWWWWWWWWWWaaaaaWWWWWWWWWW
WWWWWWWWWWWWWWWWWWWWWWWWWWWWWWWWWWWWWWWWWWWWWWWWWW