WWWWWaaaaaWWWWWWWWWWWWWWWWWWWWWWWWWWWWWWWWWWWWWWWW
WWWLg     mLWWWWWWW     WWWWWWWWWW     WWWWWWWWWW
WWWAg     mAWWWWWWWW     WWWWWWWWWW     WWWWWWWWWW
WWWWW     WWWWWWWWWW     WWWWWWWWWW     WWWWWWWWWW
WWWWW     WWWWWWWWWW     WWWWWWWWWW     WWWWWWWWWW
WWWWW     WWWWWWWWWW     WWWWWWWWWW     WWWWWWWWWW
WWWWW     WWWWWWWWWW     WWWWWWWWWW     WWWWWWWWWW
WWWWW     WWWWWWWWWW     WWWWWWWWWW     WWWWWWWWWW
WWWWW     WWWWWWWWWW     WWWWWWWWWW     WWWWWWWWWW

WWWWW     WWWWWWWWWW     WWWWWWWWWW     WWWWW
WWWWW     WWWWWWWWWW     WWWWWWWWWW     WWWWW
WWWWW     WWWWWWWWWW     WWWWWWWWWW     WWWWW
WWWWW     WWWWWWWWWW     WWWWWWWWWW     WWWWW
WWWWW     WWWWWWWWWW     WWWWWWWWWW     WWWWW
WWWWm     gAWWWWWWWW     WWWWWWWWWW     WWWWW
WWWWm     gLWWWWWWWW     WWWWWWWWWW     WWWWW
WWWWWWWWWWWWWWWWWWWWWWWWWWWWWWWWWWWWWWWWWWWWW
WWWWWWWWWWWWWWWWWWWWWWWWWWWWWWWWWWWWWWWWWWWWW
WWWWWWWWWWWWWWWWWWWWWWWWWWWWWWWWWWWWWWWWWWWWW
WWWWWWWWWWWWWWWWWWWWWWWWWWWWWWWWWWWWWWWWWWWWW
WWWWWWWWWWWWWWWWWWWWWWWWWWWWWWWWWWWWWWWWWWWWW
WWWWW     WWWWWWWWWW     WWWWWWWWWW     WWWWW
WWWWW     WWWWWWWWWW     WWWWWWWWWW     WWWWW 
WWWWW     WWWWWWWWWW     WWWWWWWWWW     WWWWW 
WWWWW     WWWWWWWWWW     WWWWWWWWWW     WWWWW 
WWWWW     WWWWWWWWWW     WWWWWWWWWW     WWWWW 
WWWWW     WWWWWWWWWW     WWWWWWWWWW     WWWWW 
WWWWW     WWWWWWWWWW     WWWWWWWWWW     WWWWW 
WWWWW     WWWWWWWWWW     WWWWWWWWWW     WWWWW 

    WWWWW     WWWWWWWWWW     WWWWWWWWWW     WWWWWWWWW
    WWWWW     WWWWWWWWWW     WWWWWWWWWW     WWWWWWWWW
    WWWWW     WWWWWWWWWW     WWWWWWWWWW     WWWWWWWWW
    WWWWW     WWWWWWWWWW     WWWWWWWWWW     WWWWWWWWWW
    WWWWW     WWWWWWWWWW     WWWWWWWWWW     WWWWW
    WWWWW     WWWWWWWWWW     WWWWWWWWWW     WWWWW
    WWWWW     WWWWWWWWWW     WWWWWWWWWW     WWWWW
    WWWWWWWWWWWWWWWWWWWWWWWWWWWWWWWWWWWWWWWWWWWWW
    WWWWWWWWWWWWWWWWWWWWWWWWWWWWWWWWWWWWWWWWWWWWWW
    W     WWWWWWWWWW     WWWWWWWWWW     WWWWWWWWWW
    W     WWWWWWWWWW     WWWWWWWWWW     WWWWWWWWWW
    W     WWWWWWWWWW     WWWWWWWWWW     WWWWWWWWWW
    W     WWWWWWWWWW     WWWWWWWWWW     WWWWWWWWWW
    W     WWWWWWWWWW     WWWWWWWWWW     WWWWWWWWWW
    W     WWWWWWWWWW     WWWWWWWWWW     WWWWWWWWWW
    W     WWWWWWWWWW     WWWWWWWWWW     WWWWWWWWWW
    W     WWWWWWWWWW     WWWWWWWWWW     WWWWWWWWWW

WWWWW     WWWWWWWWWW     WWWWWWWWWW     WWWWW
WWWWW     WWWWWWWWWW     WWWWWWWWWW     WWWWW
WWWWW     WWWWWWWWWW     WWWWWWWWWW     WWWWW
WWWWW     WWWWWWWWWW     WWWWWWWWWW     WWWWW
WWWWW     WWWWWWWWWW     WWWWWWWWWW     WWWWW
WWWWW     WWWWWWWWWW     WWWWWWWWWW     WWWWW
WWWWW     WWWWWWWWWW     WWWWWWWWWW     WWWWW
WWWWWWWWWWWWWWWWWWWWWWWWWWWWWWWWWWWWWWWWWWWWW
WWWWWWWWWWWWWWWWWWWWWWWWWWWWWWWWWWWWWWWWWWWWW
WWWWWWWWWWWWWWWWWWWWWWWWWWWWWWWWWWWWWWWWWWWWW