WWWWWWWWWWWWWWWWWWWWWWWWWWWWWWWWWWWWWWWWWWWWWWWWWWWWWWWWWWWWWWWaaaaaWWWWWWWWWWWWWWWWWWWWWWWWWWWWWWWWWWWWWWWWWWWWWWWWWWWWWWWWWWWWWWWWWWWWWWWWWWWWWWWWWWWWWWWWWWWWWWWWWWWWWWWWWWWWWaaaaaWWWWWWWWWWWWWWWWWWWWWWWWWWWWWWWWWWWWWWWWWWWWWWWWWWWWWWWWWWWWWWWWWWWWWWWWWWWWWWWWWWWWWWWWWWWWWWWWWWWWWWWWWWWWWWWWWWWWWWWWWWWWWWWWWWWWWWWWWWWWWWWWWWWWWWWWWWWWWWWWWW
WWW W  a  W WWWWWW W  a  W WWWWWWWW     WWWWWWW   a  WWWWWWWWW        WWWWWWWW  a  WWWWWWWW  a  WWWWWWWWWW  a  WWWWWWWWWW     WWWWWWWW  a  WWWWWWWWWW  a  WWWWWWWWWW     WWWWWWWW     WWWWWWWWWW  a  WWWWWWWWWW     WWWWWWWW  a  WWWWWWWWWW     WWWWWWWWWW     WWWWWWWW  a  WWWWWWWWWW  a  WWWWWWWWWW     WWWWWWWW     WWWWWWWWWW     WWWWWWWWWW  a  WWW
WWW Wm   gW WWWWWW m     g WWWWWWWW     WWWWWWWg     mWWWWWWWWm     g WWWWWWWm     gWWWWWWg     mWWWWWWWAm     gWWWWWWWWW     WWWWWWWg     mWWWWWWWWg     mWWWWWWWWW     WWWWWWWW     WWWWWWWWWm     gWWWWWWWWW     WWWWWWWg     mWWWWWWWWW     WWWWWWWWWW     WWWWWWWg     mWWWWWWWWm     gWWWWWWWWW     WWWWWWWW     WWWWWWWWWW     WWWWWWWWWg     mWW
WWWWW     WLWWWWWWWW     WWWWWWWWWW     WWWWWWWW     WWWWWWWWWW     WWWWWWWWWW     WWWWWWWW     WWWWWWWWWW     WWWWWWWWWW     WWWWWWWW     WWWWWWWWWW     WWWWWWWWWW     WWWWWWWW     WWWWWWWWWW     WWWWWWWWWW     WWWWWWWW     WWWWWWWWWW     WWWWWWWWWW     WWWWWWWW     WWWWWWWWWW     WWWWWWWWWW     WWWWWWWW     WWWWWWWWWW     WWWWWWWWWW     WWW
WWWWW     WAWWWWWWWW     WWWWWWWWWW     WWWWWWWW     WWWWWWWWWW     WWWWWWWWWW     WWWWWWWW     WWWWWWWWWW     WWWWWWWWWW     WWWWWWWW     WWWWWWWWWW     WWWWWWWWWW     WWWWWWWW     WAWWWWWWWW     WWWWWWWWWW     WWWWWWWW     WWWWWWWWWW     WWWWWWWWWW     WWWWWWWW     WWWWWWWWWW     WWWWWWWWWW     WWWWWWWW     WAWWWWWWWW     WWWWWWWWWW     WWW
WWWWW     WWWWWWWWWW     WWWWWWWWWW     WWWWWWWW     WWWWWWWWWW     WWWWWWWWWW     WWWWWWWW     WWWWWWWWWW     WWWWWWWWWW     WWWWWWWW     WWWWWWWWWW     WWWWWWWWWW     WWWWWWWW     WWWWWWWWWW     WWWWWWWWWW     WWWWWWWW     WWWWWWWWWW     WWWWWWWWWW     WWWWWWWW     WWWWWWWWWW     WWWWWWWWWW     WWWWWWWW     WWWWWWWWWW     WWWWWWWWWW     WWW
WWWWW     WWWWWWWWWW     WWWWWWWWWW     WWWWWWWW     WWWWWWWWWW     WWWWWWWWWW     WWWWWWWW     WWWWWWWWWW     WWWWWWWWWW     WWWWWWWW     WWWWWWWWWW     WWWWWWWWWW     WWWWWWWW     WWWWWWWWWW     WWWWWWWWWW     WWWWWWWW     WWWWWWWWWW     WWWWWWWWWW     WWWWWWWW     WWWWWWWWWW     WWWWWWWWWW     WWWWWWWW     WWWWWWWWWW     WWWWWWWWWW     WWW
WWWWW    LWWWWWWWWWW    LWWWWWWWWWW     WWWWWWWW    LWWWWWWWWWW    LWWWWWWWWWW     WWWWWWWW    LWWWWWWWWWW    LWWWWWWWWWW     WWWWWWWW    LWWWWWWWWWW    LWWWWWWWWWW     WWWWWWWW    LWWWWWWWWWW    LWWWWWWWWWW     WWWWWWWW    LWWWWWWWWWW     WWWWWWWWWW     WWWWWWWW    LWWWWWWWWWW    LWWWWWWWWWW     WWWWWWWW     WWWWWWWWWW     WWWWWWWWWW    LWWW
WWWWW      WWWWWWWWW     WWWWWWWWWW     WWWWWWWW     WWWWWWWWWW     WWWWWWWWWW     WWWWWWWW     WWWWWWWWWW     WWWWWWWWWW     WWWWWWWW     WWWWWWWWWW     WWWWWWWWWW     WWWWWWWW     WWWWWWWWWW     WWWWWWWWWW     WWWWWWWW     WWWWWWWWWW     WWWWWWWWWW     WWWWWWWW     WWWWWWWWWW     WWWWWWWWWW     WWWWWWWW     WWWWWWWWWW     WWWWWWWWWW     WWW

A

WWWWW      WWWWWWWWW     WWWWWWWWWW     WWWWWWWW     WWWWWWWWWW     WWWWWWWWWW     WWWWWWWW     WWWWWWWWWW     WWWWWWWWWW     WWWWWWWW     WWWWWWWWWW     WWWWWWWWWW     WWWWWWWW     WWWWWWWWWW     WWWWWWWWWW     WWWWWWWW     WWWWWWWWWW     WWWWWWWWWW     WWWWWWWW     WWWWWWWWWW     WWWWWWWWWW     WWWWWWWW     WWWWWWWWWW     WWWWWWWWWW     WWW
WWWWW     WWWWWWWWWW     WWWWWWWWWW    LWWWWWWWW     WWWWWWWWWW     WWWWWWWWWW    LWWWWWWWW     WWWWWWWWWW     WWWWWWWWWW    LWWWWWWWW     WWWWWWWWWW     WWWWWWWWWW    LWWWWWWWW     WWWWWWWWWW     WWWWWWWWWW    LWWWWWWWW     WWWWWWWWWW    LWWWWWWWWWW    LWWWWWWWW     WWWWWWWWWW     WWWWWWWWWW    LWWWWWWWW    LWWWWWWWWWW    LWWWWWWWWWW    LWWW
WWWWW     WWWWWWWWWW     WWWWWWWWWW     WWWWWWWW     WWWWWWWWWW     WWWWWWWWWW     WWWWWWWW     WWWWWWWWWW     WWWWWWWWWW     WWWWWWWW     WWWWWWWWWW     WWWWWWWWWW     WWWWWWWW     WWWWWWWWWW     WWWWWWWWWW     WWWWWWWW     WWWWWWWWWW     WWWWWWWWWW     WWWWWWWW     WWWWWWWWWW     WWWWWWWWWW     WWWWWWWW     WWWWWWWWWW     WWWWWWWWWW     WWW
WWWWW     WWWWWWWWWW     WWWWWWWWWW     WWWWWWWW     WWWWWWWWWW     WWWWWWWWWW     WWWWWWWW     WWWWWWWWWW     WWWWWWWWWW     WWWWWWWW     WWWWWWWWWW     WWWWWWWWWW     WWWWWWWW     WWWWWWWWWW     WWWWWWWWWW     WWWWWWWW     WWWWWWWWWW     WWWWWWWWWW     WWWWWWWW     WWWWWWWWWW     WWWWWWWWWW     WWWWWWWW     WWWWWWWWWW     WWWWWWWWWW     WWW
WWWWW     WWWWWWWWWW     WWWWWWWWWW     WWWWWWWW     WWWWWWWWWW     WWWWWWWWWW     WWWWWWWW     WWWWWWWWWW     WWWWWWWWWW     WWWWWWWW     WWWWWWWWWW     WWWWWWWWWW     WWWWWWWW     WWWWWWWWWW     WWWWWWWWWW     WWWWWWWW     WWWWWWWWWW     WWWWWWWWWW     WWWWWWWW     WWWWWWWWWW     WWWWWWWWWW     WWWWWWWW     WWWWWWWWWW     WWWWWWWWWW     WWW
WWWWW     WWWWWWWWWW     WWWWWWWWWW     WWWWWWWW     WWWWWWWWWW     WWWWWWWWAg     mAWWWWWm     gWWWWWWWWm     gWWWWWWWWW     WWWWWWWW     WWWWWWWWWW     WWWWWWWWWW     WWWWWWWW     WWWWWWWWWW     WWWWWWWWWW     WWWWWWWW     WWWWWWWWWW     WWWWWWWWWW     WWWWWWWW     WWWWWWWWWW     WWWWWWWWWW     WWWWWWWW     WWWWWWWWWW     WWWWWWWWWW     WWW
WWWWW     WWWWWWWWWW     WWWWWWWWWg     mWWWWWWW     WWWWWWWWWm     gWWWWWWWWg     mLWWWWWm     gWWWWWWWWm     gWWWWWWWWg     mWWWWWWW     WWWWWWWWWW     WWWWWWWWWg     mWWWWWWW     WWWWWWWWWW     WWWWWWWWWg     mWWWWWWW     WWWWWWWWWm     gWWWWWWWWg     mWWWWWWW     WWWWWWWWWW     WWWWWWWW g     mWWWWWWm     gWWWWWWWWm     gWWWWWWWWW     WWW
WWWWW     WWWWWWWWWW     WWWWWWWWWW  a  WWWWWWWWWWWWWWWWWWWWWWW  a  WWWWWWWWWWaaaaaWWWWWWWWaaaaaWWWWWWWWWWaaaaaWWWWWWWWWW  a  WWWWWWWWWWWWWWWWWWWWWWWWWWWWWWWWWWWWWW  a  WWWWWWWW     WWWWWWWWWW     WWWWWWWWWW  a  WWWWWWWW     WWWWWWWWWW  a  WWWWWWWWWW  a  WWWWWWWW     WWWWWWWWWW     WWWWWWWWWW     WWWWWWWW  a  WWWWWWWWWW  a  WWWWWWWWWW     WWW
WWWWWWWWWWWWWWWWWWWWWWWWWWWWWWWWWWWWWWWWWWWWWWWWWWWWWWWWWWWWWWWWWWWWWWWWWWWWWWWWWWWWWWWWWWWWWWWWWWWWWWWWWWWWWWWWWWWWWWWWWWWWWWWWWWWWWWWWWWWWWWWWWWWWWWWWWWWWWWWWWWWWWWWWWWWWWWWWWWWWWWWWWWWWWWWWWWWWWWWWWWWWWWWWWWWWWWWWWWWWWWWWWWWWWWWWWWWWWWWWWWWWWWWWWWWWWWWWWWWWWWWWWWWWWWWWWWWWWWWWWWWWWWWWWWWWWWWWWWWWWWWWWWWWWWWWWWWWWWWWWWWWWWWWWWWWWWWWWWWWWWWW


