WWWWWWWWWWWWWWWWWWWWWWWWWWWWWWWWWWWWWWWWWWWWWWWWWWWWWWWWWWWWWWWWWWWWWWWWWWWWWWWWWWWWWWWWWWWWWWWWWWWWWWWWWWWWWWWWWWWWWWWWWWWWWWWWWWWWWWW
W                W              W W                W              W W                W              W W                W              W
W   A            W              W W   A            W              W W   A            W              W W   A            W              W
W                W              W W                W              W W                W              W W                W              W
W                W              W W                W              W W                W              W W                W              W
W       W        W              W W                W              W W       W        W              W W                W              W
W       W        W              W W                W              W W       W        W              W W                W              W
W       W        W  g           W W       W        W  g           W W       W        W  g           W W                W  g           W
W   a   W        W              W W   a   W        W              W W   a   W        W              W W   a            W              W
WWWWWWWWW        WWWWWWW        W WWWWWWWW        WWWWWWW        W WWWWWWWWWW      WWWWWWW        W WWWWWWWWWW       WWWWWWWW         W
W                               W W                               W W                               W W                               W
W                               W W                               W W                               W W                               W
W                               W W                               W W                               W W                               W
W                      WWWWWWWWWW W                      WWWWWWWWWW W                      WWWWWWWWWW W                      WWWWWWWWWW
W                               W W                               W W                               W W                               W
W                          m    W W                          m    W W                          m    W W                          m    W
W                               W W                               W W                               W W                               W
W                               W W                               W W                               W W                               W
WWWWWWWWWWWWWWWWWWWWWWWWWWWWWWWWWWWWWWWWWWWWWWWWWWWWWWWWWWWWWWWWWWWWWWWWWWWWWWWWWWWWWWWWWWWWWWWWWWWWWWWWWWWWWWWWWWWWWWWWWWWWWWWWWWWWWWW
WWWWWWWWWWWWWWWWWWWWWWWWWWWWWWWWWWWWWWWWWWWWWWWWWWWWWWWWWWWWWWWWWWWWWWWWWWWWWWWWWWWWWWWWWWWWWWWWWWWWWWWWWWWWWWWWWWWWWWWWWWWWWWWWWWWWWWW
W                W              W W                W              W W                W              W W                W              W
W   A            W              W W   A            W              W W   A            W              W W   A            W              W
W                W              W W                W              W W                W              W W                W              W
W                W              W W                W              W W                W              W W                W              W
W                W              W W                W              W W       W        W              W W                W              W
W       W        W              W W                W              W W       W        W              W W                W              W
W       W        W  g           W W       W        W  g           W W       W        W  g           W W                W  g           W
W   m   W        W              W W   a   W        W              W W   a   W        W              W W   a            W              W
WWWWWWWWW        WWWW           W WWWWWWWW        WWWWWWW        W WWWWWWWWWW      WWWWWWW        W WWWWWWWWWW       WWWWWWWW         W
W                               W W                               W W                               W W                               W
W                               W W                               W W                               W W                               W
W                               W W                               W W                               W W                               W
W                          WWWWWW W                      WWWWWWWWWW W                      WWWWWWWWWW W                      WWWWWWWWWW
W                               W W                               W W                               W W                               W
W                          m    W W                          m    W W                          m    W W                          m    W
W                               W W                               W W                               W W                               W
W                               W W                               W W                               W W                               W
WWWWWWWWWWWWWWWWWWWWWWWWWWWWWWWWWWWWWWWWWWWWWWWWWWWWWWWWWWWWWWWWWWWWWWWWWWWWWWWWWWWWWWWWWWWWWWWWWWWWWWWWWWWWWWWWWWWWWWWWWWWWWWWWWWWWWWW
WWWWWWWWWWWWWWWWWWWWWWWWWWWWWWWWWWWWWWWWWWWWWWWWWWWWWWWWWWWWWWWWWWWWWWWWWWWWWWWWWWWWWWWWWWWWWWWWWWWWWWWWWWWWWWWWWWWWWWWWWWWWWWW
W             W W             W W             W W             W W      W      W W             W W             W W             W
W  A      g   W W  A          W W          A  W W   g      A  W W  A   W      W W  A          W W          A  W W         A   W
W             W W             W W             W W             W W      W      W W             W W             W W             W
W   m    a    W W         g   W W   g         W W             W W      W  g   W W         g   W W   g         W W             W
W WWWWWWWWWWWWW W             W W      W      W W      W      W W             W W      W      W W      W      W W      W      W
W A      g     W W  m   W      W W      W   m  W W      W   m  W W  m          W W  m   W      W W      W   m  W W      W   m  W
W              W WWWWWWWW      W W      WWWWWWWW W      WWWWWWWW W WWWWWW      WWWWWWWWWW    W W         WWWWWWW     WWWWWWWWWWW
W   m      a   W              W W             W W      W      W W             W W              W W             W W      W     W
W              WW W             W W             W W      W      W W             W W             W W             W W      W    W
WWWWWWWWWWWWWW W             W W             W W         a   W W             W W             W W             W W      W  a   W
W  m   a   g  W W  a   W      W W      W  a   W W             W W  a          W W  a   W      W W       W  a  W W             W
W             W W      W      W W      W      W W             W W      W      W W      W      W W       W     W W    g        W
W A           W W      WWWWWWWW WWWWWWWW      W WWWWW         W W      WWWWWWWW W      WWWWWWWW W       W WWWWW               W
WWWWWWWWWWWWWWWWWWWWWWWWWWWWWWWWWWWWWWWWWWWWWWWWWWWWWWWWWWWWWWWWWWWWWWWWWWWWWWWWWWWWWWWWWWWWWWWWWWWWWWWWWWWWWWWWWWWWWWWWWWWWWWW
W A            W  A             W m         W m W                 W W                               W W                       W
W            g W               WW               W                 W W                               W W                               W
W              W              g W               W                 W W                               W W                               W
W              W W              W               W                 W W                               W W                               W
W m            W m              WWWW            W                 W W                               W W                               W
W              W               WW g             W                 W W                               W W                               W
W           a  W               aW             a W                 W W                               W W                               W
W              W                W            W  W                 W W
WWWWWWWWWWWWWWWWWWWWWWWWWWWWWWWWWWWWWWWWWWWWWWWWWWWWWWWWWWWWWWWWWWWWWWWWWWWWWWWWWWWWWWWWWWWWWWWWWWWWWWWWWWWWWWWWWWWWWWWWWWWWWWW